----------------------------------------------------------------------
-                                                                    -
-                                                                    -
-                                                                    -
-                             %                      *               -
-                       ---    --    --   ---      ----             @-
-        1      <   --                          %          -----------
--------------------                                                 -
-                                                                    -
-                                                                    -
-                                                                    -
-                                                                    -
-                                                                    -
-                                                                    -
-                                                                    -
-                                                                    -
-                                                                    -
-                                                                    -
-*********************************************************           -
----------------------------------------------------------------------