----------------------------------------------------------------------
-                                                                    -
-                      *                                              -
-                -                                                    -
-             -                      *           #                     -
-           -         ---    --     --   ---                          -
-         -      ----                          %                     -
--                                                 -
-                                                                    -
-                                                                    -
-                                                                    -
-                                                                    -
-                                                                    -
-                                                                    -
-                    <                                               -
-        *      ----------                                           -
-----    ----                                                         -
-                                                                    -
- ********************************************************           -
----------------------------------------------------------------------