----------------------------------------------------------------------
-                                                                    -
-                                                                    -
-                -                                                    -
-             -                      *           #                     -
-           -         ---    --     --   ---                          -
-         -   @  <  ----                          %                     -
-------------------                                                  -
-                                                                    -
-                                                                    -
-                                                                    -
-                                                                    -
-                                                                    -
-                                                                    -
-                                                                    -
-                                                                    -
-                                                                    -
-                                                                    -
- ********************************************************           -
----------------------------------------------------------------------