----------------------------------------------------------------------
-                                                                    -
-                                                                    -
-                                                                    -
-                                   *           #                     -
-                    ---    --     --   ---                          -
-              <  ----                          %                     -
--   ---     ------                                                  -
-                                                                    -
-                                                                    -
-                                                                    -
-                                                                    -
-                                                                    -
-                                                                    -
-                                                                    -
-                                                                    -
-                                                                    -
-                                                                    -
- ********************************************************           -
----------------------------------------------------------           -
                                                         -           -
                                                         -           -
                                                         -           -
                                                         -           -
                                                         -           -
                                                         -           -
                                                         -           -
                                                         -           -
                                                         -           -
                                                         -           -
                                                         -           -
                                                         -           -
                                    %                     -           -
                              --- --   ----     --       -           -
                                              -          -           -
-************************************************-                   -
----------------------------------------------------------------------





